##############
#            #
#            #
#  O   X   P #
#          ###
#            #
##############
