#########
#     O #
#       #
#       #
#      ##
#     X #
#    P  #
#       #
#########
